Name,Volume,Ask Size,Ask Price,Bid Size,Bid Price,Last Price,Shares Matched,Shares Routed
UVXY,2069833,0,0.00,0,0.00,15.55,2039712,30121
VXX,1681454,0,0.00,0,0.00,20.61,1633420,48034
ARKG,1070405,0,0.00,0,0.00,76.66,1066110,4295
USMV,633469,0,0.00,0,0.00,77.87,626513,6956
IEFA,543925,0,0.00,0,0.00,77.01,538702,5223
RSX,499636,0,0.00,0,0.00,31.98,494333,5303
ITB,388095,0,0.00,0,0.00,71.71,384726,3369
INDA,343969,0,0.00,0,0.00,49.51,339820,4149
EZU,312483,0,0.00,0,0.00,50.86,312331,152
IGV,220682,0,0.00,0,0.00,439.03,218741,1941
PAVE,199676,0,0.00,0,0.00,28.13,191871,7805
EFV,195560,0,0.00,0,0.00,52.22,192384,3176
MTUM,193795,0,0.00,0,0.00,193.00,193549,246
VIXY,176671,0,0.00,0,0.00,16.80,168698,7973
VLUE,151448,0,0.00,0,0.00,104.74,148027,3421
CBOE,147332,0,0.00,0,0.00,135.07,144639,2693
GOVT,140069,0,0.00,0,0.00,26.48,139020,1049
ARKQ,126047,0,0.00,0,0.00,87.42,126025,22
USHY,123500,0,0.00,0,0.00,41.16,123050,450
SVXY,119142,0,0.00,0,0.00,62.80,110777,8365
ECH,114828,0,0.00,0,0.00,25.25,82345,32483
JPST,96936,0,0.00,0,0.00,50.58,96936,0
IYZ,85645,0,0.00,0,0.00,32.75,83040,2605
QUAL,81481,0,0.00,0,0.00,142.42,80151,1330
EFG,80315,0,0.00,0,0.00,111.99,72985,7330
MOAT,65652,0,0.00,0,0.00,76.64,64512,1140
IGE,64632,0,0.00,0,0.00,32.24,64632,0
KAPR,62766,0,0.00,0,0.00,28.18,62766,0
BBIN,61660,0,0.00,0,0.00,61.03,61550,110
IDV,54020,0,0.00,0,0.00,31.18,54020,0
BBEU,53203,0,0.00,0,0.00,60.43,52651,552
FCPI,46992,0,0.00,0,0.00,33.03,46992,0
REM,45802,0,0.00,0,0.00,37.61,45702,100
BBJP,41197,0,0.00,0,0.00,57.99,33924,7273
PICK,40311,0,0.00,0,0.00,41.76,39010,1301
EFAV,39217,0,0.00,0,0.00,77.19,38456,761
RYLD,37809,0,0.00,0,0.00,25.48,36959,850
ICSH,36025,0,0.00,0,0.00,50.43,33925,2100
FLOT,35881,0,0.00,0,0.00,50.77,35881,0
VNM,31906,0,0.00,0,0.00,20.35,31740,166
IYT,31329,0,0.00,0,0.00,273.97,30930,399
ARKX,30347,0,0.00,0,0.00,20.44,29995,352
ITA,28068,0,0.00,0,0.00,104.62,27681,387
NOBL,27947,0,0.00,0,0.00,94.87,27436,511
BBAX,27858,0,0.00,0,0.00,56.68,26958,900
BBCA,26449,0,0.00,0,0.00,68.23,25889,560
CEMB,24920,0,0.00,0,0.00,51.39,18920,6000
FGRO,24543,0,0.00,0,0.00,22.19,24478,65
HEFA,23897,0,0.00,0,0.00,35.74,21702,2195
NEAR,23404,0,0.00,0,0.00,50.02,22165,1239
ESGV,22913,0,0.00,0,0.00,86.36,22782,131
BUFD,21993,0,0.00,0,0.00,21.17,21993,0
BBUS,21980,0,0.00,0,0.00,84.64,21980,0
HYD,20742,0,0.00,0,0.00,61.86,20542,200
SMIN,19987,0,0.00,0,0.00,61.55,19987,0
VSGX,19150,0,0.00,0,0.00,63.75,15550,3600
SLVP,18202,0,0.00,0,0.00,13.89,18202,0
NUSC,18099,0,0.00,0,0.00,46.15,17865,234
FBCG,18054,0,0.00,0,0.00,35.39,18054,0
VUSB,17123,0,0.00,0,0.00,50.05,16523,600
OGIG,16588,0,0.00,0,0.00,56.22,16541,47
ICVT,16222,0,0.00,0,0.00,102.96,15621,601
CALF,15507,0,0.00,0,0.00,44.70,15428,79
IZRL,15116,0,0.00,0,0.00,31.55,14142,974
BMAR,14217,0,0.00,0,0.00,34.18,14217,0
KNG,13858,0,0.00,0,0.00,55.41,13858,0
COWZ,13778,0,0.00,0,0.00,45.89,13778,0
PNOV,13632,0,0.00,0,0.00,30.62,13632,0
FCTR,12746,0,0.00,0,0.00,35.73,12746,0
BUYZ,12070,0,0.00,0,0.00,51.04,12070,0
AFIF,11643,0,0.00,0,0.00,9.67,11643,0
IBML,11492,0,0.00,0,0.00,25.96,11492,0
ICF,11029,0,0.00,0,0.00,71.18,10829,200
IAGG,10845,0,0.00,0,0.00,54.97,10709,136
ACWV,10703,0,0.00,0,0.00,106.09,10703,0
QSPT,10550,0,0.00,0,0.00,20.71,10550,0
GSEW,10548,0,0.00,0,0.00,71.41,10548,0
IEO,10415,0,0.00,0,0.00,64.46,10315,100
PMAY,10286,0,0.00,0,0.00,30.28,10286,0
FLDR,9801,0,0.00,0,0.00,50.77,6906,2895
ESML,9707,0,0.00,0,0.00,41.76,8272,1435
ITM,9661,0,0.00,0,0.00,50.98,9561,100
PRNT,9543,0,0.00,0,0.00,38.59,9543,0
CNYA,9269,0,0.00,0,0.00,42.88,9069,200
JMST,8888,0,0.00,0,0.00,51.04,8888,0
FRNW,8805,0,0.00,0,0.00,28.83,5069,3736
EEMV,8687,0,0.00,0,0.00,63.14,8592,95
NULG,8350,0,0.00,0,0.00,72.61,8350,0
PAWZ,8265,0,0.00,0,0.00,82.76,8265,0
FDRV,7879,0,0.00,0,0.00,28.77,5926,1953
XMPT,7588,0,0.00,0,0.00,29.23,7588,0
NULV,7330,0,0.00,0,0.00,39.59,5330,2000
YPS,7279,0,0.00,0,0.00,24.31,7279,0
OILK,6939,0,0.00,0,0.00,57.33,6939,0
EYLD,6936,0,0.00,0,0.00,35.40,6936,0
TAIL,6895,0,0.00,0,0.00,18.08,6895,0
FPRO,6771,0,0.00,0,0.00,25.58,6771,0
IBHD,6696,0,0.00,0,0.00,24.60,6696,0
BBRE,6673,0,0.00,0,0.00,105.02,5183,1490
GVI,6661,0,0.00,0,0.00,114.48,6261,400
IFRA,6301,0,0.00,0,0.00,36.50,6300,1
IGHG,6276,0,0.00,0,0.00,75.50,6276,0
JCPB,6226,0,0.00,0,0.00,54.37,6226,0
DDLS,6088,0,0.00,0,0.00,35.53,6088,0
BJUN,5925,0,0.00,0,0.00,34.04,5925,0
BJAN,5864,0,0.00,0,0.00,36.96,5864,0
EMGF,5735,0,0.00,0,0.00,51.21,5735,0
FPFD,5667,0,0.00,0,0.00,25.39,5667,0
SMB,5648,0,0.00,0,0.00,17.92,5648,0
ATMP,5352,0,0.00,0,0.00,16.91,5352,0
SVAL,5302,0,0.00,0,0.00,32.01,5302,0
EMTL,5271,0,0.00,0,0.00,49.88,3836,1435
PSFD,5236,0,0.00,0,0.00,23.87,5236,0
BUFR,5178,0,0.00,0,0.00,23.72,5178,0
PTMC,5104,0,0.00,0,0.00,36.67,5104,0
EMHY,4952,0,0.00,0,0.00,43.47,4892,60
VOTE,4891,0,0.00,0,0.00,54.81,4762,129
TSJA,4877,0,0.00,0,0.00,29.55,4877,0
FDG,4739,0,0.00,0,0.00,87.68,3939,800
DOCT,4658,0,0.00,0,0.00,32.78,4658,0
UNOV,4640,0,0.00,0,0.00,29.35,4640,0
FMAG,4509,0,0.00,0,0.00,24.59,4509,0
LQDI,4483,0,0.00,0,0.00,30.46,4483,0
PJUN,4473,0,0.00,0,0.00,31.90,4473,0
SMMV,4447,0,0.00,0,0.00,38.77,4447,0
BNOV,4381,0,0.00,0,0.00,32.37,4381,0
FCLD,4317,0,0.00,0,0.00,27.09,1460,2857
CEFS,4226,0,0.00,0,0.00,21.79,4226,0
IQDG,4058,0,0.00,0,0.00,39.70,4058,0
KOCT,4026,0,0.00,0,0.00,27.89,4026,0
NUMG,3833,0,0.00,0,0.00,58.45,3833,0
JEMA,3760,0,0.00,0,0.00,48.24,3760,0
OMFS,3668,0,0.00,0,0.00,42.87,3668,0
WFHY,3596,0,0.00,0,0.00,52.36,3433,163
OMFL,3346,0,0.00,0,0.00,49.67,3246,100
VIXM,3306,0,0.00,0,0.00,29.86,3206,100
VFVA,3285,0,0.00,0,0.00,104.34,3085,200
ADME,3263,0,0.00,0,0.00,41.84,3263,0
DFEB,3121,0,0.00,0,0.00,34.95,3121,0
EDEN,3090,0,0.00,0,0.00,114.55,2917,173
GSST,3017,0,0.00,0,0.00,50.60,3017,0
SMMD,3012,0,0.00,0,0.00,68.77,3012,0
TOKE,2989,0,0.00,0,0.00,13.56,1704,1285
EPRF,2965,0,0.00,0,0.00,24.29,2965,0
LVHI,2956,0,0.00,0,0.00,26.17,2956,0
PTLC,2952,0,0.00,0,0.00,40.63,2952,0
REGL,2837,0,0.00,0,0.00,71.94,2748,89
IEDI,2816,0,0.00,0,0.00,46.79,2816,0
HEEM,2789,0,0.00,0,0.00,30.76,2289,500
BOB,2748,0,0.00,0,0.00,27.60,2748,0
SMDV,2738,0,0.00,0,0.00,65.19,2684,54
HYXU,2724,0,0.00,0,0.00,55.01,2724,0
GSID,2718,0,0.00,0,0.00,57.42,2718,0
SULR,2712,0,0.00,0,0.00,35.93,1112,1600
FJAN,2600,0,0.00,0,0.00,33.75,2600,0
FLQL,2598,0,0.00,0,0.00,44.95,2598,0
DRSK,2563,0,0.00,0,0.00,29.55,2563,0
VXZ,2562,0,0.00,0,0.00,25.06,2562,0
TMFC,2561,0,0.00,0,0.00,43.28,2004,557
XJR,2539,0,0.00,0,0.00,40.68,2539,0
PAUG,2508,0,0.00,0,0.00,30.08,2508,0
PJUL,2474,0,0.00,0,0.00,30.49,2474,0
QVAL,2466,0,0.00,0,0.00,36.69,2466,0
FYLD,2413,0,0.00,0,0.00,27.65,2413,0
PJAN,2402,0,0.00,0,0.00,33.10,2402,0
GOAT,2401,0,0.00,0,0.00,40.10,2051,350
VFMO,2367,0,0.00,0,0.00,139.77,2367,0
DDEC,2354,0,0.00,0,0.00,32.45,2354,0
OUSA,2349,0,0.00,0,0.00,44.16,2349,0
THY,2300,0,0.00,0,0.00,24.82,2300,0
BLKC,2298,0,0.00,0,0.00,28.67,1115,1183
FBCV,2264,0,0.00,0,0.00,29.37,1864,400
IBMN,2259,0,0.00,0,0.00,27.87,2259,0
NURE,2216,0,0.00,0,0.00,38.65,2216,0
GTIP,2182,0,0.00,0,0.00,58.17,2182,0
NUDM,2144,0,0.00,0,0.00,32.80,2144,0
MINN,2126,0,0.00,0,0.00,24.94,2126,0
PSEP,2125,0,0.00,0,0.00,30.10,2125,0
KJAN,2117,0,0.00,0,0.00,31.91,2117,0
PTNQ,2112,0,0.00,0,0.00,58.32,1706,406
XSHQ,2067,0,0.00,0,0.00,38.90,2067,0
DALT,2066,0,0.00,0,0.00,10.84,2066,0
DIVB,2049,0,0.00,0,0.00,43.00,1835,214
IEME,1967,0,0.00,0,0.00,36.63,1967,0
SYLD,1899,0,0.00,0,0.00,64.32,1789,110
IETC,1894,0,0.00,0,0.00,60.07,1693,201
PTEU,1888,0,0.00,0,0.00,25.36,1888,0
PMAR,1862,0,0.00,0,0.00,31.25,1862,0
PDEC,1815,0,0.00,0,0.00,30.96,1815,0
NUMV,1813,0,0.00,0,0.00,38.84,1813,0
EGIS,1807,0,0.00,0,0.00,35.17,1807,0
IGEB,1779,0,0.00,0,0.00,53.73,1779,0
MLN,1772,0,0.00,0,0.00,21.40,1772,0
PSMM,1718,0,0.00,0,0.00,15.76,1618,100
MSTB,1676,0,0.00,0,0.00,32.21,1576,100
OUSM,1667,0,0.00,0,0.00,36.81,1667,0
FFEB,1653,0,0.00,0,0.00,37.90,1653,0
HSRT,1619,0,0.00,0,0.00,40.75,1619,0
JPHY,1618,0,0.00,0,0.00,51.65,1618,0
EWUS,1616,0,0.00,0,0.00,47.07,1616,0
OSCV,1616,0,0.00,0,0.00,35.03,1516,100
LYFE,1611,0,0.00,0,0.00,32.51,1611,0
DINT,1608,0,0.00,0,0.00,20.76,1608,0
IEIH,1606,0,0.00,0,0.00,36.00,1606,0
MSVX,1587,0,0.00,0,0.00,25.16,1587,0
DSEP,1574,0,0.00,0,0.00,32.80,1574,0
QDEC,1562,0,0.00,0,0.00,22.90,1562,0
IEHS,1559,0,0.00,0,0.00,44.12,1559,0
NJAN,1550,0,0.00,0,0.00,42.20,1550,0
NOVZ,1530,0,0.00,0,0.00,32.84,1530,0
FIBR,1497,0,0.00,0,0.00,100.04,1497,0
MAMB,1479,0,0.00,0,0.00,25.38,1279,200
XSHD,1477,0,0.00,0,0.00,22.72,1477,0
SHYD,1462,0,0.00,0,0.00,24.91,1462,0
SECT,1458,0,0.00,0,0.00,43.78,958,500
FAUG,1440,0,0.00,0,0.00,38.13,1261,179
VFMF,1416,0,0.00,0,0.00,107.03,1416,0
DFNV,1412,0,0.00,0,0.00,30.75,1412,0
QTOC,1401,0,0.00,0,0.00,25.91,1401,0
NUEM,1395,0,0.00,0,0.00,34.20,1395,0
TMAT,1369,0,0.00,0,0.00,23.76,1369,0
VFQY,1354,0,0.00,0,0.00,125.54,1104,250
PBSM,1332,0,0.00,0,0.00,41.06,1332,0
HYIN,1331,0,0.00,0,0.00,25.73,1331,0
MBCC,1317,0,0.00,0,0.00,29.70,1317,0
BUFF,1260,0,0.00,0,0.00,35.61,1260,0
EAOM,1260,0,0.00,0,0.00,29.27,1260,0
DNOV,1258,0,0.00,0,0.00,35.00,1258,0
PAPR,1251,0,0.00,0,0.00,29.11,1251,0
TMDV,1250,0,0.00,0,0.00,48.84,1250,0
IVSG,1215,0,0.00,0,0.00,14.36,1215,0
XJH,1213,0,0.00,0,0.00,39.07,1213,0
BOSS,1202,0,0.00,0,0.00,37.17,1202,0
RSXJ,1171,0,0.00,0,0.00,39.77,1171,0
DFNL,1161,0,0.00,0,0.00,32.25,1161,0
IVDG,1146,0,0.00,0,0.00,14.33,1146,0
EAOA,1142,0,0.00,0,0.00,34.52,1142,0
FDHT,1139,0,0.00,0,0.00,26.89,1105,34
AVDR,1118,0,0.00,0,0.00,31.63,1118,0
DWLD,1110,0,0.00,0,0.00,31.20,1110,0
MIG,1100,0,0.00,0,0.00,24.89,700,400
HEGD,1099,0,0.00,0,0.00,19.14,1099,0
NULC,1094,0,0.00,0,0.00,43.70,1094,0
BUFT,1075,0,0.00,0,0.00,20.05,1075,0
MEAR,1053,0,0.00,0,0.00,50.14,1053,0
FFHG,1047,0,0.00,0,0.00,37.47,1047,0
IEFN,1027,0,0.00,0,0.00,34.18,1027,0
CBTG,1013,0,0.00,0,0.00,21.05,1013,0
XDQQ,1000,0,0.00,0,0.00,29.95,1000,0
ACIO,991,0,0.00,0,0.00,31.73,991,0
FMIL,964,0,0.00,0,0.00,30.09,964,0
FDEM,933,0,0.00,0,0.00,25.82,933,0
FOCT,919,0,0.00,0,0.00,35.18,919,0
LEAD,919,0,0.00,0,0.00,57.98,919,0
UJAN,919,0,0.00,0,0.00,31.45,919,0
TILT,917,0,0.00,0,0.00,180.89,917,0
UJUL,900,0,0.00,0,0.00,27.45,700,200
DBOC,878,0,0.00,0,0.00,29.92,378,500
IVAL,858,0,0.00,0,0.00,27.26,858,0
IGRO,852,0,0.00,0,0.00,67.76,852,0
ESG,839,0,0.00,0,0.00,113.43,839,0
FDEC,834,0,0.00,0,0.00,34.11,834,0
PFEB,820,0,0.00,0,0.00,29.03,820,0
TTAC,818,0,0.00,0,0.00,58.06,818,0
BDEC,813,0,0.00,0,0.00,34.03,813,0
GSUS,809,0,0.00,0,0.00,64.43,809,0
PSMB,803,0,0.00,0,0.00,17.06,803,0
FMAY,800,0,0.00,0,0.00,37.76,800,0
VFLQ,798,0,0.00,0,0.00,116.81,798,0
PSFF,786,0,0.00,0,0.00,22.62,786,0
XVV,786,0,0.00,0,0.00,35.64,786,0
ESGG,779,0,0.00,0,0.00,150.00,779,0
PBND,758,0,0.00,0,0.00,25.76,758,0
PWS,756,0,0.00,0,0.00,34.36,756,0
SATO,731,0,0.00,0,0.00,31.00,568,163
QMAR,727,0,0.00,0,0.00,22.47,427,300
JPIB,718,0,0.00,0,0.00,50.70,718,0
UMAY,717,0,0.00,0,0.00,28.60,717,0
QMOM,716,0,0.00,0,0.00,53.66,716,0
WUGI,713,0,0.00,0,0.00,64.27,713,0
DDWM,711,0,0.00,0,0.00,30.79,711,0
DMAR,700,0,0.00,0,0.00,31.63,200,500
IYLD,695,0,0.00,0,0.00,24.05,695,0
TRTY,694,0,0.00,0,0.00,28.22,694,0
ENOR,670,0,0.00,0,0.00,30.83,670,0
BAPR,657,0,0.00,0,0.00,32.88,557,100
GAA,656,0,0.00,0,0.00,31.98,656,0
IBMM,641,0,0.00,0,0.00,26.85,641,0
GMOM,622,0,0.00,0,0.00,30.89,622,0
TDV,612,0,0.00,0,0.00,63.28,612,0
DFND,605,0,0.00,0,0.00,40.50,605,0
MBBB,600,0,0.00,0,0.00,25.00,600,0
IBHC,595,0,0.00,0,0.00,24.57,595,0
MPRO,590,0,0.00,0,0.00,27.24,590,0
DUSA,585,0,0.00,0,0.00,35.20,585,0
DFHY,576,0,0.00,0,0.00,24.71,576,0
LUXE,567,0,0.00,0,0.00,31.84,567,0
BSEP,555,0,0.00,0,0.00,32.85,461,94
IECS,553,0,0.00,0,0.00,32.86,553,0
IBHE,534,0,0.00,0,0.00,24.83,534,0
IYJ,527,0,0.00,0,0.00,111.59,527,0
VCEB,527,0,0.00,0,0.00,73.92,339,188
EFAD,512,0,0.00,0,0.00,47.68,512,0
DSOC,511,0,0.00,0,0.00,32.81,511,0
IDHD,507,0,0.00,0,0.00,27.08,507,0
DJUL,500,0,0.00,0,0.00,33.36,500,0
DJUN,500,0,0.00,0,0.00,34.21,500,0
FJUL,500,0,0.00,0,0.00,36.05,500,0
NOCT,500,0,0.00,0,0.00,40.18,500,0
UAPR,500,0,0.00,0,0.00,26.17,500,0
AESR,494,0,0.00,0,0.00,14.65,121,373
FFTG,493,0,0.00,0,0.00,30.66,493,0
BJUL,467,0,0.00,0,0.00,32.90,467,0
VFMV,462,0,0.00,0,0.00,102.30,462,0
DUDE,451,0,0.00,0,0.00,29.35,451,0
FLV,439,0,0.00,0,0.00,61.98,439,0
BBSA,417,0,0.00,0,0.00,51.25,417,0
PBUS,410,0,0.00,0,0.00,47.18,410,0
UFEB,404,0,0.00,0,0.00,27.84,404,0
IBHF,403,0,0.00,0,0.00,25.28,403,0
IDME,401,0,0.00,0,0.00,25.07,401,0
PBDM,401,0,0.00,0,0.00,29.81,401,0
UJUN,400,0,0.00,0,0.00,29.28,400,0
XDSQ,400,0,0.00,0,0.00,28.41,400,0
IVLC,385,0,0.00,0,0.00,14.82,385,0
DAUG,353,0,0.00,0,0.00,34.99,353,0
QLC,352,0,0.00,0,0.00,50.42,352,0
DJAN,351,0,0.00,0,0.00,32.12,351,0
FNOV,350,0,0.00,0,0.00,38.55,350,0
FFSG,346,0,0.00,0,0.00,37.46,346,0
HELX,345,0,0.00,0,0.00,53.89,345,0
GVAL,336,0,0.00,0,0.00,24.12,336,0
LKOR,331,0,0.00,0,0.00,60.60,331,0
VAMO,330,0,0.00,0,0.00,25.75,330,0
ROMO,328,0,0.00,0,0.00,29.59,328,0
FFTI,321,0,0.00,0,0.00,24.02,321,0
FDEV,318,0,0.00,0,0.00,29.91,318,0
IQM,318,0,0.00,0,0.00,55.40,318,0
FSMO,317,0,0.00,0,0.00,24.54,317,0
HYDB,317,0,0.00,0,0.00,51.45,317,0
BFEB,315,0,0.00,0,0.00,31.73,315,0
JMUB,315,0,0.00,0,0.00,54.66,315,0
FAPR,301,0,0.00,0,0.00,32.09,301,0
IGLD,301,0,0.00,0,0.00,19.94,201,100
XBAP,301,0,0.00,0,0.00,27.14,301,0
DAPR,300,0,0.00,0,0.00,31.29,300,0
FUT,300,0,0.00,0,0.00,41.01,300,0
KWT,300,0,0.00,0,0.00,35.89,300,0
UAUG,300,0,0.00,0,0.00,29.04,300,0
AGT,298,0,0.00,0,0.00,28.49,298,0
HYHG,296,0,0.00,0,0.00,62.61,296,0
ISVL,296,0,0.00,0,0.00,37.16,296,0
PSMC,290,0,0.00,0,0.00,13.92,290,0
XTOC,289,0,0.00,0,0.00,25.41,289,0
ADFI,272,0,0.00,0,0.00,9.68,272,0
FJUN,254,0,0.00,0,0.00,37.45,254,0
EFNL,244,0,0.00,0,0.00,48.14,244,0
TTAI,240,0,0.00,0,0.00,37.05,240,0
PSMG,233,0,0.00,0,0.00,18.99,133,100
MOTI,209,0,0.00,0,0.00,34.20,209,0
XBOC,201,0,0.00,0,0.00,24.95,201,0
BMAY,200,0,0.00,0,0.00,32.68,200,0
JULZ,200,0,0.00,0,0.00,34.36,200,0
PLTL,200,0,0.00,0,0.00,26.49,200,0
MFMS,189,0,0.00,0,0.00,40.02,140,49
FRDM,185,0,0.00,0,0.00,33.05,185,0
MDEV,180,0,0.00,0,0.00,26.62,180,0
EUDV,172,0,0.00,0,0.00,54.81,172,0
GCOW,172,0,0.00,0,0.00,30.30,172,0
IVRA,166,0,0.00,0,0.00,15.00,166,0
FSEP,160,0,0.00,0,0.00,35.45,160,0
GHYG,160,0,0.00,0,0.00,49.49,160,0
XDJL,150,0,0.00,0,0.00,27.26,150,0
FEDX,137,0,0.00,0,0.00,28.78,137,0
FLQS,127,0,0.00,0,0.00,40.25,127,0
ALTS,125,0,0.00,0,0.00,39.29,125,0
OEUR,111,0,0.00,0,0.00,28.93,111,0
WIL,109,0,0.00,0,0.00,105.23,2,107
GLDB,105,0,0.00,0,0.00,23.95,105,0
BOCT,102,0,0.00,0,0.00,34.10,102,0
SPMV,102,0,0.00,0,0.00,39.33,102,0
UDEC,101,0,0.00,0,0.00,29.81,101,0
NJUL,100,0,0.00,0,0.00,47.74,100,0
PSMO,100,0,0.00,0,0.00,21.01,100,0
STOT,100,0,0.00,0,0.00,49.34,100,0
XJUN,100,0,0.00,0,0.00,30.40,100,0
XTAP,100,0,0.00,0,0.00,28.38,100,0
ZECP,100,0,0.00,0,0.00,25.72,100,0
EAOK,90,0,0.00,0,0.00,28.02,90,0
IBMO,90,0,0.00,0,0.00,26.83,90,0
IBMP,89,0,0.00,0,0.00,26.92,89,0
BUFG,86,0,0.00,0,0.00,20.12,86,0
ALFA,83,0,0.00,0,0.00,88.22,83,0
SFIG,68,0,0.00,0,0.00,51.02,68,0
VIRS,68,0,0.00,0,0.00,34.82,68,0
FLHY,65,0,0.00,0,0.00,26.25,65,0
BGLD,64,0,0.00,0,0.00,18.88,64,0
FLQM,64,0,0.00,0,0.00,46.71,64,0
EAOR,63,0,0.00,0,0.00,31.83,63,0
MRSK,61,0,0.00,0,0.00,33.05,61,0
YSEP,55,0,0.00,0,0.00,20.19,55,0
AVDG,53,0,0.00,0,0.00,31.84,53,0
APXH,52,0,0.00,0,0.00,9.94,52,0
DURA,51,0,0.00,0,0.00,31.40,51,0
EWGS,48,0,0.00,0,0.00,83.76,48,0
FOMO,41,0,0.00,0,0.00,25.72,41,0
IMOM,41,0,0.00,0,0.00,35.32,41,0
PLRG,40,0,0.00,0,0.00,28.10,40,0
CSM,35,0,0.00,0,0.00,107.20,35,0
MAGA,30,0,0.00,0,0.00,38.75,30,0
STLG,29,0,0.00,0,0.00,39.14,29,0
JANZ,28,0,0.00,0,0.00,29.69,28,0
XDAP,28,0,0.00,0,0.00,28.39,28,0
VMOT,27,0,0.00,0,0.00,27.95,27,0
TBJL,26,0,0.00,0,0.00,24.32,26,0
ACSI,24,0,0.00,0,0.00,52.30,24,0
VWID,22,0,0.00,0,0.00,28.92,22,0
IBHB,20,0,0.00,0,0.00,24.18,20,0
EUCG,18,0,0.00,0,0.00,27.44,18,0
BALT,17,0,0.00,0,0.00,25.85,17,0
FLBL,17,0,0.00,0,0.00,25.00,17,0
PEX,16,0,0.00,0,0.00,37.95,16,0
ESHY,12,0,0.00,0,0.00,20.98,12,0
TEGS,12,0,0.00,0,0.00,30.54,12,0
ICOW,11,0,0.00,0,0.00,31.27,11,0
BAUG,10,0,0.00,0,0.00,32.82,10,0
DECZ,10,0,0.00,0,0.00,30.06,10,0
EMDV,9,0,0.00,0,0.00,57.22,9,0
HYMU,9,0,0.00,0,0.00,26.02,9,0
XDAT,9,0,0.00,0,0.00,29.63,9,0
FLIA,6,0,0.00,0,0.00,25.06,6,0
IAUF,6,0,0.00,0,0.00,54.70,6,0
SLT,6,0,0.00,0,0.00,44.42,6,0
SHAG,5,0,0.00,0,0.00,50.76,5,0
EOPS,4,0,0.00,0,0.00,26.79,4,0
JUNZ,4,0,0.00,0,0.00,26.84,4,0
SMI,4,0,0.00,0,0.00,49.64,4,0
YJUN,3,0,0.00,0,0.00,20.46,3,0
GOVZ,2,0,0.00,0,0.00,21.87,2,0
IMFL,2,0,0.00,0,0.00,26.72,2,0
OBND,2,0,0.00,0,0.00,29.89,2,0
WDNA,2,0,0.00,0,0.00,26.05,2,0
BLDG,1,0,0.00,0,0.00,32.57,1,0
IBMQ,1,0,0.00,0,0.00,27.05,1,0
KNGS,1,0,0.00,0,0.00,28.72,1,0
MAAX,1,0,0.00,0,0.00,24.58,1,0
PSMJ,1,0,0.00,0,0.00,21.09,1,0
REC,1,0,0.00,0,0.00,24.69,1,0
RTAI,1,0,0.00,0,0.00,27.59,1,0
TCTL,1,0,0.00,0,0.00,34.15,1,0
TSOC,1,0,0.00,0,0.00,32.00,1,0
WFIG,1,0,0.00,0,0.00,54.06,1,0
AMER,0,0,0.00,0,0.00,0.00,0,0
APRZ,0,0,0.00,0,0.00,0.00,0,0
ARCM,0,0,0.00,0,0.00,0.00,0,0
AUGZ,0,0,0.00,0,0.00,0.00,0,0
CFCV,0,0,0.00,0,0.00,0.00,0,0
DBJA,0,0,0.00,0,0.00,0.00,0,0
DMAY,0,0,0.00,0,0.00,0.00,0,0
DSJA,0,0,0.00,0,0.00,0.00,0,0
EMSH,0,0,0.00,0,0.00,0.00,0,0
ESCR,0,0,0.00,0,0.00,0.00,0,0
ESEB,0,0,0.00,0,0.00,0.00,0,0
EURZ,0,0,0.00,0,0.00,0.00,0,0
FAIL,0,0,0.00,0,0.00,0.00,0,0
FEBZ,0,0,0.00,0,0.00,0.00,0,0
FMAR,0,0,0.00,0,0.00,0.00,0,0
FUNL,0,0,0.00,0,0.00,0.00,0,0
GSEE,0,0,0.00,0,0.00,0.00,0,0
HCRB,0,0,0.00,0,0.00,0.00,0,0
HEET,0,0,0.00,0,0.00,0.00,0,0
HSUN,0,0,0.00,0,0.00,0.00,0,0
IBHA,0,0,0.00,0,0.00,0.00,0,0
IBHG,0,0,0.00,0,0.00,0.00,0,0
IMLP,0,0,0.00,0,0.00,0.00,0,0
KJUL,0,0,0.00,0,0.00,0.00,0,0
LIV,0,0,0.00,0,0.00,0.00,0,0
LSLT,0,0,0.00,0,0.00,0.00,0,0
MARZ,0,0,0.00,0,0.00,0.00,0,0
MAYZ,0,0,0.00,0,0.00,0.00,0,0
MBND,0,0,0.00,0,0.00,0.00,0,0
MOTE,0,0,0.00,0,0.00,0.00,0,0
MRGR,0,0,0.00,0,0.00,0.00,0,0
NAPR,0,0,0.00,0,0.00,0.00,0,0
NUDV,0,0,0.00,0,0.00,0.00,0,0
OCTZ,0,0,0.00,0,0.00,0.00,0,0
PBEE,0,0,0.00,0,0.00,0.00,0,0
PBTP,0,0,0.00,0,0.00,0.00,0,0
POCT,0,0,0.00,0,0.00,0.00,0,0
PSCJ,0,0,0.00,0,0.00,0.00,0,0
PSCQ,0,0,0.00,0,0.00,0.00,0,0
PSCW,0,0,0.00,0,0.00,0.00,0,0
PSCX,0,0,0.00,0,0.00,0.00,0,0
PSFJ,0,0,0.00,0,0.00,0.00,0,0
PSFM,0,0,0.00,0,0.00,0.00,0,0
PSFO,0,0,0.00,0,0.00,0.00,0,0
PSMD,0,0,0.00,0,0.00,0.00,0,0
PSMR,0,0,0.00,0,0.00,0.00,0,0
PXUS,0,0,0.00,0,0.00,0.00,0,0
QCON,0,0,0.00,0,0.00,0.00,0,0
QJUN,0,0,0.00,0,0.00,0.00,0,0
QPFF,0,0,0.00,0,0.00,0.00,0,0
QTAP,0,0,0.00,0,0.00,0.00,0,0
QTJL,0,0,0.00,0,0.00,0.00,0,0
RDFI,0,0,0.00,0,0.00,0.00,0,0
RESD,0,0,0.00,0,0.00,0.00,0,0
RESE,0,0,0.00,0,0.00,0.00,0,0
RODE,0,0,0.00,0,0.00,0.00,0,0
RODI,0,0,0.00,0,0.00,0.00,0,0
SEPZ,0,0,0.00,0,0.00,0.00,0,0
STLV,0,0,0.00,0,0.00,0.00,0,0
TFJL,0,0,0.00,0,0.00,0.00,0,0
TYA,0,0,0.00,0,0.00,0.00,0,0
UMAR,0,0,0.00,0,0.00,0.00,0,0
UOCT,0,0,0.00,0,0.00,0.00,0,0
USEP,0,0,0.00,0,0.00,0.00,0,0
USEQ,0,0,0.00,0,0.00,0.00,0,0
USMF,0,0,0.00,0,0.00,0.00,0,0
WLDR,0,0,0.00,0,0.00,0.00,0,0
XBJL,0,0,0.00,0,0.00,0.00,0,0
XDOC,0,0,0.00,0,0.00,0.00,0,0
XTJL,0,0,0.00,0,0.00,0.00,0,0
YDEC,0,0,0.00,0,0.00,0.00,0,0
YMAR,0,0,0.00,0,0.00,0.00,0,0